NO mandatory/images/b.png
SO mandatory/images/b.png
WE mandatory/images/b.png
EA mandatory/images/b.png

F 0, 255, 0
C 0, 0, 255

111111111111111111
100000000000000001
100000000000000001
1000000S0000000001
100000000000000001
100000000000000001
111111111111111111