NO bonus/images/gtawall.png
SO bonus/images/gtawall.png
WE bonus/images/gtawall.png
EA bonus/images/gtawall.png

F 98,92,89
C 236, 211, 167

11111111111111111111111111111111111111111111111111111111111111111111111111111111111111111111111111111111
100L00000000000000000000L00000000000000000000L000000000000000000Y00000000000000000000L00000000000000L001
10000000000000000000000000000000000000Y00000000000000000000000000000000000000000000000000000000000000001
1000000000Y000000000000000000000000000000000000000000000000000000000000000000000000000000000000000000001
1000000000000000000000000000000000000100000000000000000000000000000000000000000000000000000000000Y000001
100000000000000000Y000000000000000001110000000000000000001000000000L000000000000000000000000000000000001
10Y00011111111L1111111111111L1111001111100111L11111111111l1111111111111111111111111111111111111111000001
1000001111111111011011T1111111111001111100111111111111100y0010111111111111111111111111101011111111000001
1000T000000000000T000000000000000000111000000000000000111D11100000000000000000000T0000000000000000000001
10000000000000000000000000000000000001000000000000000000000000000000000000000000000000000Y00000000000001
10000000000000000000000000000000000000000000000000000000000000000000000000000000000000000000000000000001
10000000000000000000000000000000000000000000000000000000000000000000000Y00000000000000000000000000000001
100000L000000000T0000T00001000000000000T00010000T00010000T000010000T0000000T000000000000000000000000L001
11111111111111111111111111110000111111111111111111111111111111111111111111111111111111111111111111111111
         1111111110100000000000000000001
         111TT10110000000000000000000T01
         11TTT1000111000100000001T111111
         111T111110001D10101110111011101111
         11TT0T1000000010100010T0001T10101
         111101T1110111110101111111T1010111
         110100T10100000000T1T00T01T100011
         1111011101011111111101011TTT1111
          11110101000101TTTTT101T0TT0011
           1111111101011111111111111111
            10111110111110111111111
             111111N1111111111111
                 1111111111111