NO bonus/images/88.png
SO bonus/images/88.png
WE bonus/images/88.png
EA bonus/images/88.png

F 0, 255, 0
C 0, 0, 255

111111111111111111
100000000000000001
100000000000000001
1000000E0000000001
100000000000000001
100000000000000001
111111111111111111